Green = 1
Blue = 2
Black = 3
Brown = 4
Tan = 5

Map = 20x20

{
{5, 1, 1, 1, 1, 1, 1, 2, 2, 2, 2, 2, 2, 1, 1, 3, 3, 1, 1, 3},
{5, 5, 1, 1, 1, 1, 3, 2, 2, 2, 2, 2, 1, 1, 1, 1, 3, 1, 3, 1},
{5, 5, 1, 1, 3, 1, 1, 3, 2, 2, 2, 1, 1, 1, 1, 1, 1, 1, 3, 1},
{5, 1, 4, 4, 1, 3, 1, 1, 1, 1, 1, 1, 1, 1, 1, 1, 1, 4, 4, 1},
{5, 1, 4, 4, 1, 3, 3, 1, 1, 1, 1, 1, 1, 1, 1, 1, 1, 4, 4, 1},
{5, 1, 1, 4, 4, 1, 1, 1, 1, 1, 1, 1, 1, 1, 2, 2, 4, 4, 1, 1},
{5, 5, 1, 4, 4, 1, 1, 1, 1, 1, 1, 1, 2, 2, 2, 2, 4, 4, 1, 1},
{5, 5, 1, 1, 4, 4, 1, 1, 1, 1, 1, 2, 2, 2, 2, 4, 4, 1, 1, 1},
{5, 5, 5, 1, 4, 4, 1, 1, 1, 1, 4, 2, 2, 2, 2, 4, 4, 1, 1, 1},
{5, 5, 5, 1, 1, 4, 4, 1, 1, 4, 4, 4, 2, 2, 4, 4, 1, 1, 1, 1},
{5, 5, 1, 1, 1, 4, 4, 1, 1, 4, 4, 4, 2, 2, 4, 4, 1, 1, 1, 1},
{5, 5, 1, 1, 1, 1, 4, 4, 4, 4, 1, 4, 4, 4, 4, 1, 1, 1, 1, 3},
{5, 5, 1, 1, 1, 1, 1, 4, 4, 1, 1, 1, 4, 4, 1, 1, 1, 1, 3, 3},
{5, 5, 5, 5, 1, 1, 1, 4, 4, 1, 1, 1, 4, 4, 1, 1, 3, 1, 3, 3},
{5, 5, 5, 5, 1, 1, 1, 1, 1, 1, 1, 1, 1, 1, 1, 1, 1, 3, 1, 3},
{5, 5, 5, 1, 1, 1, 1, 1, 1, 1, 1, 1, 1, 1, 1, 1, 1, 3, 3, 1},
{5, 5, 1, 1, 1, 1, 1, 1, 1, 1, 1, 5, 5, 1, 1, 1, 3, 1, 3, 1},
{5, 1, 1, 1, 1, 5, 5, 1, 1, 1, 1, 5, 5, 5, 5, 1, 1, 3, 1, 1},
{5, 1, 1, 1, 5, 5, 5, 5, 5, 5, 5, 5, 5, 5, 5, 5, 1, 1, 1, 1},
{5, 5, 5, 5, 5, 5, 5, 5, 5, 5, 5, 5, 5, 5, 5, 5, 5, 5, 5, 5}
}
